C 20,151,222
F 137,136,133

NO assets/textures/baboon.png
EA assets/textures/baboon.png
WE assets/textures/baboon.png
SO assets/textures/baboon.png


11111111111111111111111111111111111111111111111111111111111111111111111111111111
11000100010001000100010001000100010001000100010001000100010001000100010001000101
1E010001000100010001000100010001000100010001000100010001000100010001000100010001
11111111111111111111111111111111111111111111111111111111111111111111111111111111
