SO assets/textures/backroom.png
NO assets/textures/backroom.png
EA assets/textures/backroom.png
WE assets/textures/backroom.png

C 138,137,97
F 96,95,67

111111111111111
100000000000001
100010000000001
100010000000001
100010011001111
111110010001001
100000010000001
100000010000001
1000N0010000001
111111111111111
