SO assets/textures/bomberman_wall_normal.png
NO assets/textures/bomberman_wall_desert.png
EA assets/textures/bomberman_wall_normal.png
WE assets/textures/bomberman_wall_desert.png

F 0,127,0
C 130,202,255

111111111111111111111111111111111111111111111111111111111111111
100000000000000000000000000000000000000000000000000000000000001
10S010101010101010101010101010101010101010101010101010101010101
100000000000000000000000000000000000000000000000000000000000001
101010101010101010101010101010101010101010101010101010101010101
100000000000000000000000000000000000000000000000000000000000001
101010101010101010101010101010101010101010101010101010101010101
100000000000000000000000000000000000000000000000000000000000001
101010101010101010101010101010101010101010101010101010101010101
100000000000000000000000000000000000000000000000000000000000001
101010101010101010101010101010101010101010101010101010101010101
100000000000000000000000000000000000000000000000000000000000001
101010101010101010101010101010101010101010101010101010101010101
100000000000000000000000000000000000000000000000000000000000001
101010101010101010101010101010101010101010101010101010101010101
100000000000000000000000000000000000000000000000000000000000001
101010101010101010101010101010101010101010101010101010101010101
100000000000000000000000000000000000000000000000000000000000001
101010101010101010101010101010101010101010101010101010101010101
100000000000000000000000000000000000000000000000000000000000001
101010101010101010101010101010101010101010101010101010101010101
100000000000000000000000000000000000000000000000000000000000001
101010101010101010101010101010101010101010101010101010101010101
100000000000000000000000000000000000000000000000000000000000001
101010101010101010101010101010101010101010101010101010101010101
100000000000000000000000000000000000000000000000000000000000001
101010101010101010101010101010101010101010101010101010101010101
100000000000000000000000000000000000000000000000000000000000001
101010101010101010101010101010101010101010101010101010101010101
100000000000000000000000000000000000000000000000000000000000001
101010101010101010101010101010101010101010101010101010101010101
100000000000000000000000000000000000000000000000000000000000001
101010101010101010101010101010101010101010101010101010101010101
100000000000000000000000000000000000000000000000000000000000001
101010101010101010101010101010101010101010101010101010101010101
100000000000000000000000000000000000000000000000000000000000001
101010101010101010101010101010101010101010101010101010101010101
100000000000000000000000000000000000000000000000000000000000001
101010101010101010101010101010101010101010101010101010101010101
100000000000000000000000000000000000000000000000000000000000001
101010101010101010101010101010101010101010101010101010101010101
100000000000000000000000000000000000000000000000000000000000001
101010101010101010101010101010101010101010101010101010101010101
100000000000000000000000000000000000000000000000000000000000001
101010101010101010101010101010101010101010101010101010101010101
100000000000000000000000000000000000000000000000000000000000001
101010101010101010101010101010101010101010101010101010101010101
100000000000000000000000000000000000000000000000000000000000001
101010101010101010101010101010101010101010101010101010101010101
100000000000000000000000000000000000000000000000000000000000001
101010101010101010101010101010101010101010101010101010101010101
100000000000000000000000000000000000000000000000000000000000001
101010101010101010101010101010101010101010101010101010101010101
100000000000000000000000000000000000000000000000000000000000001
101010101010101010101010101010101010101010101010101010101010101
100000000000000000000000000000000000000000000000000000000000001
101010101010101010101010101010101010101010101010101010101010101
100000000000000000000000000000000000000000000000000000000000001
101010101010101010101010101010101010101010101010101010101010101
100000000000000000000000000000000000000000000000000000000000001
101010101010101010101010101010101010101010101010101010101010101
100000000000000000000000000000000000000000000000000000000000001
111111111111111111111111111111111111111111111111111111111111111
