SO assets/textures/backroom.png
NO assets/textures/backroom.png
EA assets/textures/backroom.png
WE assets/textures/backroom.png

C 138,137,97
F 96,95,67

11111
10001
10N01
10001
11111
