SO assets/textures/resident_evil/resident_evil_gaiden_bed_room.png
NO assets/textures/resident_evil/resident_evil_gaiden_bed_room.png
EA assets/textures/resident_evil/resident_evil_gaiden_elevator.png
WE assets/textures/resident_evil/resident_evil_gaiden_elevator.png

C 67,47,87
F 45,24,50

11111
10001
10N01
10001
11111