EA assets/textures/resident_evil/resident_evil_gaiden_living_room.png
WE assets/textures/resident_evil/resident_evil_gaiden_living_room.png
SO assets/textures/resident_evil/resident_evil_gaiden_staircase.png
NO assets/textures/resident_evil/resident_evil_gaiden_staircase.png

F 0,31,40
C 255,0,0

        1111111111111111111111111    111
        1000000000000000000000001    101
        1000000000110000011100001    111
        101100000111000001 100001
        1001000000000000011100001
111111111011000001110000000000001
100000000011000001110111101111111
11110111111111011100000010001
11110111111111011101010010001
11000000110101011100000010001
10000000000000001100000010001
1000E000000000001101010010001
1100000111010101111101111000111
11110111 1110101 101111010001
11111111 1111111 111111111111