NO       assets/textures/fern_north.png
           SO        assets/textures/fern_south.png
WE assets/textures/fern_west.png
EA assets/textures/fern_east.png

C     122,233,255
F 100,100,100

        1111111111111111111111111
        1000000000100000000000001
        1011000001110000000000001
        1001000000000000000000001
111111111011000001110000000000001
100000000011000001110111111111111
11110111111111011100000000001
11110111  1111011101010010011
11000000110101011100000010001
10000000000000001100000010001
10000000000000001101010010001
11000000110101011111011110W001
11110111 1110101 101111010001
11111111 1111111 111111111111

